11111111111
1000T000CC1
1C1CC00C001
1T10000P0E1
11111111111