NO ./textures/queen.xpm
SO ./textures/rook.xpm
WE ./textures/bishop.xpm
EA ./textures/knight.xpm

F 0,0,0
C 255,255,255


1111111111
1000010001
1100000001
1100000001
11000W0011
1100000011
1000111001
1111111111
